                                                                               
                                                                               
                                                                               
                                                                               
                                                                               
                                                                               
                                                                               
                                                                               
                          ###########################                          
                          ##....>..................##                          
                           ##.....................##                           
                            ##...................##                            
                             ##.................##                             
                              #########+###########                            
                                 #.........'''''''#                            
                            ######........####''''##                           
                           ##''##........##.#''''''##                          
                          ##''''..#......#..##''''''#                          
                      #####''''''##...##....#####'''#                          
                      #''##''##''###.####....## #####                          
                      #''''''##''##''#  ##....#                                
                      #'''''##''''''##  ##....#                                
                      ##''###''''''##  ##....##                                
                    ####''''''''####  ##....##                                 
                    #''''''''''##    ##......##                                
                    ##'''##'####    ##........##                               
                     ##################.#########                              
                             ##.................##                             
                            ##...................##                            
                           ##.....................##                           
                          ##....@..................##                          
                          ###########################                          
                                                                               
                                                                               
                                                                               
                                                                               
                                                                               
                                                                               
                                                                               
                                                                               
