###############################################################################
###############################################################################
################``>``##########################################################
##############..```..``########################################################
##############....`....################################################~~######
################.....##################################################~~######
##################+####################################################~~######
##################.###################################################~~#######
##################..##################################################~########
###################.###########################,,,###################~~########
###################.############,,,,,#######,,##,,##,###############~~#########
###################+#########,,,,,,,#######,,,,,,,,,,,#############~~##########
############,,,,,,,.,,,,,,,,,,,,,,,,,,,,,,,,,,,,,,,,,,,,,,,########~###########
##########,,,,,,,,#.#,,,,,,,,,,,,,,,,,,,,,,,,,,,,,,,,,,,,,,,,,####~~###########
##########,,,,,,,,,.,,,,,,,,,,,,,,,,,,,,,,,,,,,,,,,,,,,,,,,,,,,,~~,,,,#########
#########,,,,,,,,,#.#,,,,,,,,,,,,,,,,,,,,,,,,,,,,,,,,,,,,,,,~~~~~~,,,,,,#######
#########,,,,,,,,,,.,,,,,,,,,,,,,,,,,,,,,,,,,,,,,,,,,,,,,,~~~~~~~,,,,,,,#######
##########,,,,,,,,#.#,,,,,,,,,,,,,,,,,,,,,,,,,,,,,,,,~~~~~~~,,,,,,,,,,,,,######
#########,,,,,,,,,,.,,,,,,,,,,,,,,,,,,,,,,,,,~~~~~~~~~~~~~,,,,,,,,,,,,,,#######
########,,,,,,,,,,,..,,,,,,,,,,,,,,,,,,,,,~~~~~~~~~~~,,,,,,,,,,,,,,,,,#########
########,,,,,,,,,,,,..,,,,,,,,,,,,,,,,,,~~~~~,,,,,,,,,,,,,,,,,,,,,,,,##########
########,,,,,,,,,,,,,..................~~.......,,,,,,,,,,,,,,,,,,#############
#######,,,,,,,,,,,,,,,,,,,,,,,,,,,,,~~~~,,,,,,,.,,,,,,,,,,,,,,,,,,,############
########,,,,,,,,,,,,,,,,,,,,,,,,,,,,,~~~,,,,,,,..,,,,,,,,,,,,,,,,,,############
########,,,,,,,,,,,,,,,,,,,,,,,,,,,,,,~~~,,,,,,,.,,,,,,,,,,,,,,,,,#############
#######,,,,,,,,,,,,,,,,,,,,,,,,,,,,,,,,~~,,,,,,,.,,,,,,,,,,,,,,,###############
######,,,,,,,,,,,,,,,,,,,,,,,,,,,,,,,,,~~,,,,,,,.,,,,,,,,,,,,##################
######,,,,,,,,,,,,,,,,,,,,,,,,,,,,,,,~~~,,,,,,,,.,,,,,,,,,,####################
######,,,,,,,,,,,,,,,,,,,,,,,,,,,,,~~~,,,,,,,,,,.,,,,,,,,,,,###################
#######,,,,,,,,,,,,,,,,,,,,,,,,,,,,,~~~,,,,,,,,,.,,,,,,,,,,,###################
########,,,,,,,,,,,,,,,,,,,,,,,,,,,,~~,,,,,,,,,,.,,,,,,,,,,####################
############,,,,,,,,,,,,,,,,,,,,,,,~~,,,,,,,,,,,..,,,,,,,,#####################
##############,,,,,,,,,,,,,,,,,,,,,~~~,,,,,,,,,,,.,,,,,,#######################
###############,,,,,,,,,,,,,,,,,,,~~~,,,,,,,,,,,,.,,,,#########################
################,,,,,,,,,,,,,,,,,,~~~,,,,,,,,,,,..,,,##########################
#################################~~#############+##############################
################################~~##############.##############################
################################~~##############...@###########################
###############################~~##############################################
###############################################################################
