###############################################################################
#............................................................................@#
#.............................................................................#
#.............................................................................#
#.............................................................................#
#.............................................................................#
#.............................................................................#
#.............................................................................#
#.............................................................................#
#.............................................................................#
#.............................................................................#
#.............................................................................#
#.............................................................................#
#.............................................................................#
#.............................................................................#
#.............................................................................#
#.............................................................................#
#.............................................................................#
#.............................................................................#
#.............................................................................#
#.............................................................................#
#.............................................................................#
#.............................................................................#
#.............................................................................#
#.............................................................................#
#.............................................................................#
#.............................................................................#
#.............................................................................#
#.............................................................................#
#.............................................................................#
#.............................................................................#
#.............................................................................#
#.............................................................................#
#.............................................................................#
#.............................................................................#
#.............................................................................#
#.............................................................................#
#.............................................................................#
#>............................................................................#
###############################################################################
