###############################################################################
#............................................................................@#
#...............................................................`.``..........#
#...............................................................`````.........#
#...............................................................`````.........#
#........................................######.#######.........``````........#
#........................................#,,,,#.#,,,,,#..........````.........#
#........................................#,,^^^+^^^^,,#.........``````........#
#........................................###^......^###.........```...........#
#...........................................+......+............`.............#
#........................................###^......^###.......................#
#........................................#,,^^^^+^^^,,#.......................#
#................~~~~~~~~~~~~~~~~~~~~~~~~#~~~~~#~#~~~~#~~.....................#
#................~~~~~~~~~~~~~~~~~~~~~~~~#######~######~~.....................#
#................~~~~~~~~~~~~~~~~~~~~~~~~~~~~~~~~~~~~~~~~.....................#
#................''''''''''''''''''''''''''''''''''''''''.....................#
#................''''''''''''''''''''''''''''''''''''''''.....................#
#................''''''''''''''''''''''''''''''''''''''''.....................#
#................,,,,,,,,,,,,,,,,,,,,,,,,,,,,,,,,,,,,,,,,.....................#
#................,,,,,,,,,,,,,,,,,,,,,,,,,,,,,,,,,,,,,,,,.....................#
#................,,,,,,,,,,,,,,,,,,,,,,,,,,,,,,,,,,,,,,,,.....................#
#.............................................................................#
#.............................................................................#
#.............................................................................#
#.............................................................................#
#.............................................................................#
#.............................................................................#
#.............................................................................#
#.............................................................................#
#.............................................................................#
#.............................................................................#
#.............................................................................#
#.............................................................................#
#.............................................................................#
#.............................................................................#
#.............................................................................#
#.............................................................................#
#.............................................................................#
#>............................................................................#
###############################################################################
