###############################################################################
#                                                                             #
#                                                                             #
#....................#####################################                    #
#....................#...................................#                    #
#....................#.################.################.#                    #
#....................#.#...............................#.#                    #
#....................#.#.#############################.#.#                    #
#....................#.#.#...........................#.#.#                    #
#....................#.#.#.#.#####################.#.#.#.#                    #
#....................#.#.#.#.#####################.#.#.#.#                    #
#.............########.#.#.#.#####################.#.#.#.########             #
#.............#......#.#...#.#####################.#...#.#......#             #
#.............#.####.#.#####.#####################.#####.#.####.#             #
#.............#.#....#.....#.#########.@.#########.#.....#....#.#             #
#.............#.#.########.#.#########...#########.#.########.#.#             #
#.............#.#.#........#.########.....########.#........#.#.#             #
#.............#.#.#.########.########.....########.########.#.#.#             #
#.............#.#.#........#.#######.......#######.#........#.#.#             #
#.............#.#.######.###.######.........######.###.######.#.#             #
#...###########.#........###.######.........######.###........#.#             #
#...#.........#.############.######.........######.############.###########   #
#...#.......#.#............#.......................#............#.........#   #
#...#.......#.##########.###.........#####.........###.##########.#.......#   #
#...#.......#.#........#...#..........#>#..........#...#........#.#.......#   #
#...#.......#.#.######.###.#..........#.#..........#.###.######.#.#.......#   #
#...#.......#.#......#...#.#.........##.##.........#.#...#......#.#.......#   #
#...#.......#.######.###.#.#.........##.##.........#.#.###.######.#.......#   #
#...#.......#......#...#.#.#.........#...#.........#.#.#...#......#.......#   #
#...#.......######.###.#...#.........#...#.........#...#.###.######.......#   #
#...#............#.....#####.........#...#.........#####.....#............#   #
#...#............#######...############.############...#######............#   #
#...#.....................................................................#   #
#...#.....................................................................#   #
#...#######################################################################   #
#                                                                             #
#                                                                             #
#                                                                             #
#                                                                             #
###############################################################################
